00000000000000000000000000000000
00000000000000000000000000000000
00000000000000000000000000000000
00000000000000000000000000000000
00000020000000200000000C00000000
00000000000000000100000001000000
01000000010000000000000000000000
01000000000000000000000000000000
00000000010000000100000001000000
00000000000000000100000001000000
01000000000000000000000000000000
00000000010000000000000000000000
00FFEDDD00001223000000010000000E
0022D4CEFFDD2B320022D4CE00FDD226
0000000000022DDA0080000000947AE1
00004000000000000000000001000000
01000000000000000000002800000000
00000000000000000000000000000000
00000000000000000000000000000000
