00000002
0C00DCDC
0D00FFD2
0D00FFD0
0D00F450
0D00F400
C0002380
80000000
C0002300
80000000
C00023C0
80000010
C0002200
80000000
0880DCE0
0C00DCDC
0A210012
08000010
01000014
06405010
C0002000
80000027
0D00FFC1
C0002000
80000001
0D00F462
C0002000
80000000
0D00F462
C0002000
80000002
0D00FFD1
00000003
0D00FFD2
00000005
00000000
00000000
02010022
00000000
00000000
089EDCE0
089C0010
00000000
C0000000
824F0000
088ADCE0
0A230006
008C2000
0AA70005
0209003E
C0002870
80006000
008C1191
00000023
00000000
3000BCE9
0000C2F1
0100003D
06005014
36405015
26404015
092B0006
00000000
0C00FC40
0640101E
0C00FC41
0640102E
0C00FC50
0640103E
0C00FC51
0640104E
0C00003F
0640100E
C0000000
820F0014
0E010032
050C900E
00882001
00200130
00881001
00200120
0000E829
00044188
C0000000
821F0007
00D62000
0000D840
0C500030
00002080
E0428000
80024301
E0428001
80024301
E0428021
80024301
E0428005
80024301
E0428025
80024301
E0428009
80024301
E0428029
80024301
E042800D
80024301
E042802D
80024301
E0428011
80024301
E0428031
80024301
E0428015
80024301
E0428035
80024301
E0428019
80024301
E0000039
80000132
07445021
0744D021
07455021
0745D021
07465021
0746D021
07475021
C0000000
820F000D
0C730007
0600101E
0004000C
0600902E
0000E028
0004001D
0601103E
0000E0A8
0004002E
0601904E
0000E128
0004003F
061C5040
FE400006
84020800
00068900
0C51000B
00044518
00044929
054C905E
054D109E
0C400040
0600105E
00040008
00000000
054C106E
054C108E
050C106E
0084A000
0C820044
0A290043
0AA90042
2084122A
00881020
0A2D0044
0A310041
00200240
00200264
0B290043
30859330
0B2D0044
0A390043
054F107E
C0000000
821F0034
050C107E
0C40003C
0A65003D
00841001
00044108
D0002601
8F124000
0B25FD10
0A29DC30
008C1221
00200150
0B65003D
C0000000
820F0015
0611908E
E0348003
8DCC0023
06045000
F0400015
8C000400
E0B48000
80000220
E5800025
8C200000
0C48FD14
F080364E
8C6C0600
F1800012
8CB00400
0000E86D
00045548
00840353
054D90BE
C0000000
820F0019
0611909E
E0348003
8DCC0023
06045000
F0400015
8C000400
E0B48000
80000220
E5800025
8C200000
F080364E
8C6C0600
F1800012
8CB00400
0000E86D
00045548
00840353
054D90AE
060010AE
0D00FCC1
060010BE
0D00FCC0
089C0010
00000000
00002E01
00000000
099C0010
00000002
0C10F460
02C20000
00000000
00000000
00000000
00000000
